............
............
.....##.....
...##.......
............
########....
............
............
............
