................
.........-#-....
.****.....#.....
.****....-#-....
.***......#.....
.**......-#-....
..........#.....
.....#...-#-....
....###...#.....
################
