............
............
............
............
........##..
.##.........
..##....#...
............
############
