............
............
............
............
............
......##....
.....##.....
.........#..
############
