............
...******...
............
............
...-----....
............
............
............
############
