............
............
............
......--....
............
.......--...
...###....##
........####
############
