............
............
............
............
............
............
............
....###.....
############
